25 20
#############
#.......C...#    ########
#s..........######.....k#
#..............o........#
#...........######.....s#
#...........#    #......#
#...........#    #......#
#...........#    #.....g#
#.........###    ########
#####.....#
#\..#.....#
###%#.....#      ########
#..o......#      #......#
#.......G.#      #......#
#.........#      #......#
#.........########......#
#..W..........o.........#
#.........########..!...#
#.........#      #.....@#
###########      ########
