25 20
#############
#..=#s..C...#    ########
#.###.......######.....k#
#..............o........#
#...........######.....s#
#...........#    #......#
#...........#    #......#
#..s........#    #..+...#
#s........###    ########
#####.....#
#\..#.....#g
###%#.....#
#..o......#g
#.........#      ########
#.........#      #..?+..#
#.........########......#
#.............o.........#
#.........########W.....#
#s........#      #.....@#
###########      ########
