25 20
#############
#..=#...C...#    ########
#.###.......######.....k#
#...s..........o........#
#...........######...s..#
#......s....#    #......#
#...........#    #......#
#..s........#    #..+...#
#.........###    ########
#####.....#
#\..#.....#g
###%#.....#
#..o......#g
#.........#      ########
#.........#      #..?+..#
#.........########......#
#.............o.........#
#.........########W.....#
#.........#      #.....@#
###########      ########
